BBBBBBBBBBBBBBBBBBBBBBBBB
BHHHHHHHHHHHBBBBBBBBBBBBB
BHHHHHHHHHHHBBHHHGGGFFFHB
BBBBBBBBBBBBBBHHHHHHFWWWB
BGGGGGBRRRRRRRRRRRHHFRRRR
BGGGGGBRBBBRBBBBBBHBFRWWB
BGGGGGBRHHHRBBBHHHHBFRFFB
BGGGGGBRHHHRBBBBBBBBBRBBB
BGGGGGBRBBBRBHHBBBBBBRBHH
BBFGGFBRBBBRBHHBBBBBBRBGG
BBFGGFBRBBBRBHHRRRRRRRBGG
BBFGGFBRBHHRHHHHHHHHBRBHH
BBFGGFBRBHHRHHHHHHHHBRBHH
BBFFFFBRBBBRBBBBBBBBBRBGG
BBBBBBBRBBBRBBBBBBBBBRBHH
BRRRRRRRBBBRRRRRRRRRRRBBB
BBBBBBBBBBBBBBBBBBBBBBBBB
WWWWWWWWWWWWWWWWWWWWWWWWW
WWWWWWWWWWWWWWWWWWWWWWWWW
WWWWWWWWWWWWWWWWWWWWWWWWW
